"Category"	"Deduplicated reads (remaining)"	"Duplicate reads (removed)"	"Total reads before deduplication"	"PercentageDeduplicated"	"PercentageDuplicate"
"01_BAT_r1_X_GRCm38"	100273	39030	139303	71.981938651716	28.018061348284
"01_Blood_r3_X_GRCm38"	73260	29009	102269	71.6346106835894	28.3653893164106
"01_Liver_r2_X_GRCm38"	59442	29605	89047	66.7535121901917	33.2464878098083
"01_scAT_r1_X_GRCm38"	98313	37247	135560	72.5236057834169	27.4763942165831
"02_BAT_r1_X_GRCm38"	96113	36966	133079	72.2225144463063	27.7774855536937
"02_Blood_r3_X_GRCm38"	59635	25337	84972	70.181942286871	29.818057713129
"02_Liver_r2_X_GRCm38"	39255	19776	59031	66.4989581745185	33.5010418254815
"02_scAT_r1_X_GRCm38"	80976	32871	113847	71.1270389206567	28.8729610793433
"03_BAT_r1_X_GRCm38"	66647	25920	92567	71.9986604297428	28.0013395702572
"03_Liver_r2_X_GRCm38"	48405	22021	70426	68.7317183994547	31.2682816005453
"04_BAT_r1_X_GRCm38"	44034	17026	61060	72.115951523092	27.884048476908
"04_Liver_r2_X_GRCm38"	51359	24843	76202	67.3984934778615	32.6015065221385
"05_BAT_r1_X_GRCm38"	21516	8441	29957	71.8229462229195	28.1770537770805
"05_Blood_r3_X_GRCm38"	54929	23646	78575	69.9064587973274	30.0935412026726
"05_Liver_r2_X_GRCm38"	57481	27690	85171	67.4889340268401	32.5110659731599
"05_scAT_r1_X_GRCm38"	111198	45619	156817	70.9094039549284	29.0905960450716
"06_BAT_r1_X_GRCm38"	59728	23004	82732	72.1945559154861	27.8054440845139
"06_Blood_r3_X_GRCm38"	23309	9354	32663	71.36209166335	28.63790833665
"06_Liver_r2_X_GRCm38"	52255	24687	76942	67.9147929609316	32.0852070390684
"06_scAT_r1_X_GRCm38"	74658	30055	104713	71.2977376257007	28.7022623742993
"07_BAT_r1_X_GRCm38"	48089	18256	66345	72.4832315924335	27.5167684075665
"07_Blood_r3_X_GRCm38"	58639	24776	83415	70.2979080501109	29.7020919498891
"07_Liver_r2_X_GRCm38"	56976	27789	84765	67.216421872235	32.783578127765
"07_scAT_r1_X_GRCm38"	92262	37202	129464	71.2645986529074	28.7354013470926
"08_BAT_r1_X_GRCm38"	41874	16494	58368	71.7413651315789	28.2586348684211
"08_Blood_r3_X_GRCm38"	37968	16440	54408	69.7838553153948	30.2161446846052
"08_Liver_r2_X_GRCm38"	19635	8931	28566	68.7355597563537	31.2644402436463
"08_scAT_r1_X_GRCm38"	32801	14023	46824	70.0516828976593	29.9483171023407
"09_BAT_r1_X_GRCm38"	42299	16933	59232	71.4124122096164	28.5875877903836
"10_BAT_r1_X_GRCm38"	64293	25069	89362	71.9466887491327	28.0533112508673
"11_BAT_r1_X_GRCm38"	47247	17225	64472	73.2829755552798	26.7170244447202
"11_BAT_r3_X_GRCm38"	20902	9190	30092	69.4603216801808	30.5396783198192
"12_BAT_r1_X_GRCm38"	44062	16664	60726	72.5587063201923	27.4412936798077
"12_BAT_r3_X_GRCm38"	54603	23620	78223	69.8042775142861	30.1957224857139
"13_BAT_r3_X_GRCm38"	46277	19687	65964	70.1549329937542	29.8450670062458
"13_Blood_r2_X_GRCm38"	30238	14403	44641	67.7359378150131	32.2640621849869
"13_scAT_r1_X_GRCm38"	93953	38320	132273	71.0296129973615	28.9703870026385
"14_BAT_r3_X_GRCm38"	20117	9163	29280	68.7056010928962	31.2943989071038
"14_Blood_r2_X_GRCm38"	48236	22200	70436	68.4820262365836	31.5179737634164
"14_scAT_r1_X_GRCm38"	55645	23178	78823	70.5948771297718	29.4051228702282
"15_BAT_r3_X_GRCm38"	62697	27190	89887	69.75090947523	30.24909052477
"15_Blood_r2_X_GRCm38"	68148	32235	100383	67.8879890021219	32.1120109978781
"15_Liver_r1_X_GRCm38"	18165	7548	25713	70.645198926613	29.354801073387
"15_scAT_r1_X_GRCm38"	103168	42521	145689	70.8138569143861	29.1861430856139
"16_BAT_r3_X_GRCm38"	65837	29138	94975	69.3203474598579	30.6796525401421
"16_Blood_r2_X_GRCm38"	26811	13117	39928	67.1483670607093	32.8516329392907
"16_Liver_r1_X_GRCm38"	40446	15965	56411	71.6987821524171	28.3012178475829
"16_scAT_r1_X_GRCm38"	162079	66772	228851	70.8229371949434	29.1770628050566
"01_BAT_r2_X_GRCm38"	69891	27683	97574	71.6287125668723	28.3712874331277
"01_Blood_r1_X_GRCm38"	85888	32847	118735	72.3358740051375	27.6641259948625
"02_Blood_r1_X_GRCm38"	75155	28631	103786	72.4134276299308	27.5865723700692
"03_Blood_r1_X_GRCm38"	63412	22725	86137	73.6176091575049	26.3823908424951
"03_Blood_r3_X_GRCm38"	74958	32532	107490	69.7348590566564	30.2651409433436
"03_scAT_r1_X_GRCm38"	77501	32057	109558	70.739699519889	29.260300480111
"04_Blood_r3_X_GRCm38"	81493	33578	115071	70.8197547601046	29.1802452398954
"04_scAT_r1_X_GRCm38"	111287	44420	155707	71.472059701876	28.527940298124
"05_BAT_r2_X_GRCm38"	44779	18072	62851	71.2462808865412	28.7537191134588
"05_Blood_r1_X_GRCm38"	39527	15044	54571	72.4322442322845	27.5677557677155
"05_Liver_r3_X_GRCm38"	68671	28312	96983	70.8072548797212	29.1927451202788
"06_BAT_r2_X_GRCm38"	66794	28218	95012	70.3005936092283	29.6994063907717
"06_Blood_r1_X_GRCm38"	65290	23927	89217	73.1811201900983	26.8188798099017
"07_BAT_r2_X_GRCm38"	98901	42647	141548	69.8709978240597	30.1290021759403
"07_Blood_r1_X_GRCm38"	39395	14547	53942	73.0321456379074	26.9678543620926
"08_BAT_r2_X_GRCm38"	92233	38627	130860	70.4821947119058	29.5178052880941
"08_Blood_r1_X_GRCm38"	74080	28591	102671	72.1527987455075	27.8472012544925
"09_Blood_r3_X_GRCm38"	16646	6421	23067	72.1636970564009	27.8363029435991
"09_Liver_r2_X_GRCm38"	58847	28056	86903	67.7157290312187	32.2842709687813
"09_scAT_r1_X_GRCm38"	45581	16990	62571	72.8468459829633	27.1531540170366
"10_Blood_r3_X_GRCm38"	67764	29033	96797	70.0063018481978	29.9936981518022
"10_Liver_r2_X_GRCm38"	46313	23515	69828	66.3243970899925	33.6756029100074
"10_scAT_r1_X_GRCm38"	83874	34504	118378	70.8526922232171	29.1473077767828
"11_Blood_r3_X_GRCm38"	43041	18802	61843	69.5972058276604	30.4027941723396
"11_Liver_r2_X_GRCm38"	65466	33177	98643	66.3665946899425	33.6334053100575
"11_scAT_r1_X_GRCm38"	90591	38247	128838	70.3138825501793	29.6861174498207
"12_Blood_r3_X_GRCm38"	68261	27637	95898	71.1808379736804	28.8191620263196
"12_Liver_r2_X_GRCm38"	14093	6321	20414	69.035955716665	30.964044283335
"12_scAT_r1_X_GRCm38"	84704	33065	117769	71.9238509285126	28.0761490714874
"13_BAT_r1_X_GRCm38"	43602	16983	60585	71.9683089873731	28.0316910126269
"13_Blood_r3_X_GRCm38"	43470	18388	61858	70.273853018203	29.726146981797
"13_Liver_r2_X_GRCm38"	39811	19867	59678	66.7096752572137	33.2903247427863
"13_scAT_r2_X_GRCm38"	82058	40093	122151	67.17750980344	32.82249019656
"14_BAT_r1_X_GRCm38"	44664	16396	61060	73.147723550606	26.852276449394
"14_Blood_r3_X_GRCm38"	67201	28951	96152	69.8903818953324	30.1096181046676
"14_Liver_r2_X_GRCm38"	49565	23624	73189	67.721925425952	32.278074574048
"14_scAT_r2_X_GRCm38"	50507	24192	74699	67.614024284127	32.385975715873
"15_BAT_r1_X_GRCm38"	69990	27946	97936	71.4650383924195	28.5349616075805
"15_Blood_r3_X_GRCm38"	80641	34634	115275	69.9553242246801	30.0446757753199
"15_Liver_r2_X_GRCm38"	23744	10627	34371	69.0814931191993	30.9185068808007
"15_scAT_r2_X_GRCm38"	59420	26489	85909	69.166210757895	30.833789242105
"16_BAT_r1_X_GRCm38"	29505	10483	39988	73.7846353906172	26.2153646093828
"16_Blood_r3_X_GRCm38"	68425	29006	97431	70.2291878354938	29.7708121645062
"16_Liver_r2_X_GRCm38"	22332	10419	32751	68.1872309242466	31.8127690757534
"01_Liver_r3_X_GRCm38"	96063	42506	138569	69.3250294077319	30.6749705922681
"01_scAT_r2_X_GRCm38"	29240	14822	44062	66.3610367209841	33.6389632790159
"02_BAT_r2_X_GRCm38"	70891	30878	101769	69.65873694347	30.34126305653
"02_Liver_r3_X_GRCm38"	85408	38780	124188	68.7731503849003	31.2268496150997
"02_scAT_r2_X_GRCm38"	35030	12217	47247	74.1422735835079	25.8577264164921
"03_BAT_r2_X_GRCm38"	43034	18799	61833	69.5971406853945	30.4028593146055
"03_Liver_r3_X_GRCm38"	38505	18162	56667	67.9496002964688	32.0503997035312
"03_scAT_r2_X_GRCm38"	36399	16785	53184	68.4397563176895	31.5602436823105
"04_BAT_r2_X_GRCm38"	62014	26725	88739	69.8835912056706	30.1164087943294
"04_Blood_r1_X_GRCm38"	43124	16260	59384	72.6188872423548	27.3811127576452
"04_Liver_r3_X_GRCm38"	49970	15671	65641	76.1262016117975	23.8737983882025
"04_scAT_r2_X_GRCm38"	32275	14673	46948	68.7462724716708	31.2537275283292
"05_Blood_r2_X_GRCm38"	49454	19223	68677	72.0095519606273	27.9904480393727
"05_Liver_r1_X_GRCm38"	34062	12636	46698	72.9410253115765	27.0589746884235
"05_scAT_r2_X_GRCm38"	41140	19863	61003	67.4393062636264	32.5606937363736
"06_Liver_r1_X_GRCm38"	36803	13939	50742	72.5296598478578	27.4703401521422
"06_Liver_r3_X_GRCm38"	57397	25801	83198	68.9884372220486	31.0115627779514
"06_scAT_r2_X_GRCm38"	56482	26554	83036	68.021099282239	31.978900717761
"07_Liver_r1_X_GRCm38"	44849	16758	61607	72.7985456198159	27.2014543801841
"07_Liver_r3_X_GRCm38"	43790	19415	63205	69.2824934736176	30.7175065263824
"07_scAT_r2_X_GRCm38"	62747	29177	91924	68.2596492754884	31.7403507245116
"08_Liver_r3_X_GRCm38"	66351	29369	95720	69.3178019222733	30.6821980777267
"08_scAT_r2_X_GRCm38"	66233	32450	98683	67.1169299676743	32.8830700323257
"09_BAT_r2_X_GRCm38"	72960	32345	105305	69.2844594273776	30.7155405726224
"09_Blood_r1_X_GRCm38"	42871	16084	58955	72.7181748791451	27.2818251208549
"09_Liver_r3_X_GRCm38"	44179	18560	62739	70.4171249143276	29.5828750856724
"09_scAT_r2_X_GRCm38"	66320	30628	96948	68.4078062466477	31.5921937533523
"10_BAT_r2_X_GRCm38"	63438	26702	90140	70.377191036166	29.622808963834
"10_Blood_r1_X_GRCm38"	25814	9889	35703	72.3020474469932	27.6979525530068
"10_Liver_r3_X_GRCm38"	38351	16089	54440	70.4463629684056	29.5536370315944
"10_scAT_r2_X_GRCm38"	47814	21780	69594	68.7041986378136	31.2958013621864
"11_BAT_r2_X_GRCm38"	30372	14273	44645	68.0300145593012	31.9699854406988
"11_Blood_r1_X_GRCm38"	62062	22863	84925	73.0785987636149	26.921401236385
"11_Liver_r3_X_GRCm38"	56805	24242	81047	70.088960726492	29.911039273508
"11_scAT_r2_X_GRCm38"	53619	25326	78945	67.9194375831275	32.0805624168725
"12_BAT_r2_X_GRCm38"	40590	12714	53304	76.1481314723098	23.8518685276902
"12_Blood_r1_X_GRCm38"	70386	27141	97527	72.1707834753453	27.8292165246547
"12_Liver_r3_X_GRCm38"	65161	28670	93831	69.4450661295308	30.5549338704692
"13_BAT_r2_X_GRCm38"	48705	19510	68215	71.3992523638496	28.6007476361504
"13_Blood_r1_X_GRCm38"	26557	10470	37027	71.7233370243336	28.2766629756664
"13_Liver_r3_X_GRCm38"	56466	23859	80325	70.296918767507	29.703081232493
"14_BAT_r2_X_GRCm38"	26687	11070	37757	70.6809333368647	29.3190666631353
"14_Blood_r1_X_GRCm38"	25103	6644	31747	79.0720383028318	20.9279616971682
"15_BAT_r2_X_GRCm38"	44743	18779	63522	70.4370139479236	29.5629860520764
"15_Blood_r1_X_GRCm38"	55814	20371	76185	73.2611406444838	26.7388593555162
"16_BAT_r2_X_GRCm38"	62988	26735	89723	70.2027350846494	29.7972649153506
"16_Blood_r1_X_GRCm38"	36371	13487	49858	72.9491756588712	27.0508243411288
"16_scAT_r2_X_GRCm38"	54651	26099	80750	67.6792569659443	32.3207430340557
"01_BAT_r3_X_GRCm38"	50268	24926	75194	66.8510785435008	33.1489214564992
"01_Blood_r2_X_GRCm38"	39374	18373	57747	68.1836285867664	31.8163714132336
"01_Liver_r1_X_GRCm38"	10452	3754	14206	73.574545966493	26.425454033507
"02_BAT_r3_X_GRCm38"	62869	30265	93134	67.5038117121567	32.4961882878433
"02_Blood_r2_X_GRCm38"	59624	24946	84570	70.5025422726735	29.4974577273265
"02_Liver_r1_X_GRCm38"	29729	11008	40737	72.9778825146673	27.0221174853327
"03_BAT_r3_X_GRCm38"	35127	17238	52365	67.0810655972501	32.9189344027499
"03_Blood_r2_X_GRCm38"	111437	45764	157201	70.8882259018709	29.1117740981291
"03_Liver_r1_X_GRCm38"	25393	11145	36538	69.4975094422245	30.5024905577755
"04_BAT_r3_X_GRCm38"	43505	21380	64885	67.0493950836095	32.9506049163905
"04_Blood_r2_X_GRCm38"	99569	40962	140531	70.8519828365272	29.1480171634728
"04_Liver_r1_X_GRCm38"	22792	8665	31457	72.4544616460565	27.5455383539435
"05_BAT_r3_X_GRCm38"	9708	4334	14042	69.1354507904857	30.8645492095143
"05_scAT_r3_X_GRCm38"	54548	23228	77776	70.13474593705	29.86525406295
"06_BAT_r3_X_GRCm38"	25223	12377	37600	67.0824468085106	32.9175531914894
"06_Blood_r2_X_GRCm38"	26352	10486	36838	71.5348281665671	28.4651718334329
"06_scAT_r3_X_GRCm38"	91048	38567	129615	70.2449562164873	29.7550437835127
"07_BAT_r3_X_GRCm38"	13215	7419	20634	64.0447804594359	35.9552195405641
"07_Blood_r2_X_GRCm38"	11038	4319	15357	71.8760174513251	28.1239825486749
"07_scAT_r3_X_GRCm38"	71708	30635	102343	70.0663455243642	29.9336544756359
"08_BAT_r3_X_GRCm38"	27861	13620	41481	67.1656903160483	32.8343096839517
"08_Blood_r2_X_GRCm38"	35190	13928	49118	71.6437965715216	28.3562034284784
"08_Liver_r1_X_GRCm38"	23827	8918	32745	72.7653076805619	27.2346923194381
"08_scAT_r3_X_GRCm38"	65649	26810	92459	71.0033636530787	28.9966363469213
"09_BAT_r3_X_GRCm38"	36831	17272	54103	68.0757074469068	31.9242925530932
"09_Blood_r2_X_GRCm38"	75211	32274	107485	69.9734846722799	30.0265153277201
"09_Liver_r1_X_GRCm38"	44475	16662	61137	72.7464546837431	27.2535453162569
"10_BAT_r3_X_GRCm38"	34413	17264	51677	66.5924879540221	33.4075120459779
"10_Blood_r2_X_GRCm38"	51508	21794	73302	70.2682055059889	29.7317944940111
"10_Liver_r1_X_GRCm38"	47405	17913	65318	72.5757065433724	27.4242934566276
"11_Blood_r2_X_GRCm38"	99054	41827	140881	70.3104038159865	29.6895961840135
"11_Liver_r1_X_GRCm38"	26480	10052	36532	72.4843972407752	27.5156027592248
"12_Blood_r2_X_GRCm38"	60804	23537	84341	72.0930508293712	27.9069491706288
"12_Liver_r1_X_GRCm38"	36836	14457	51293	71.8148675257832	28.1851324742168
"12_scAT_r2_X_GRCm38"	35128	16510	51638	68.0274216662148	31.9725783337852
"13_Liver_r1_X_GRCm38"	36624	14212	50836	72.04343378708	27.95656621292
"13_scAT_r3_X_GRCm38"	33257	16482	49739	66.8630249904501	33.1369750095499
"14_Liver_r1_X_GRCm38"	31892	11679	43571	73.1954740538432	26.8045259461568
"14_Liver_r3_X_GRCm38"	54859	23850	78709	69.6985097002884	30.3014902997116
"14_scAT_r3_X_GRCm38"	35219	14911	50130	70.2553361260722	29.7446638739278
"15_Liver_r3_X_GRCm38"	11971	4748	16719	71.6011723189186	28.3988276810814
"15_scAT_r3_X_GRCm38"	53685	22408	76093	70.5518247407777	29.4481752592223
"16_Liver_r3_X_GRCm38"	21404	8850	30254	70.7476697296225	29.2523302703775
"16_scAT_r3_X_GRCm38"	83917	35538	119455	70.2498848938931	29.7501151061069
